####..#####
#.........#
#.........#
#.........#
....@#.....
....#......
#.........#
#..#.....##
#..#......#
####..#####