...###
..##.#.####
.#...###..#
#.@...#...#
#.....#...#
#.....#...#
#.#...#...#
.##....#.##
.#..#....#
.#.....##
.#######