####..####
#........#
#........#
#........#
....@#....
....#.....
#........#
#..#.....#
#..#.....#
####..####